{
  "하북": 1,
  "중원": 2,
  "서북": 3,
  "서촉": 4,
  "남중": 5,
  "초": 6,
  "오월": 7,
  "동이": 8
}
