{
    "낙양": 1,
    "성도": 2,
    "건업": 3,
    "업": 4,
    "장안": 5,
    "허창": 6,
    "양양": 7,
    "시상": 8,
    "수춘": 9,
    "한중": 10,
    "남피": 11,
    "위례": 12,
    "북평": 13,
    "강릉": 14,
    "완": 15,
    "장사": 16,
    "오": 17,
    "하비": 18,
    "복양": 19,
    "웅진": 20,
    "강주": 21,
    "무도": 22,
    "국내": 23,
    "진류": 24,
    "계양": 25,
    "계림": 26,
    "계": 27,
    "무위": 28,
    "제남": 29,
    "남해": 30,
    "덕양": 31,
    "하내": 32,
    "상용": 33,
    "초": 34,
    "운남": 35,
    "대": 36,
    "하동": 37,
    "무릉": 38,
    "교지": 39,
    "단양": 40,
    "영안": 41,
    "북해": 42,
    "합비": 43,
    "이릉": 44,
    "건녕": 45,
    "강하": 46,
    "진양": 47,
    "평원": 48,
    "회계": 49,
    "천수": 50,
    "평양": 51,
    "요동": 52,
    "거록": 53,
    "여강": 54,
    "패": 55,
    "자동": 56,
    "광릉": 57,
    "장가": 58,
    "영릉": 59,
    "월수": 60,
    "건안": 61,
    "신야": 62,
    "탐라": 63,
    "상동": 64,
    "안정": 65,
    "여남": 66,
    "홍농": 67,
    "주제": 68,
    "남만": 69,
    "산월": 70,
    "오환": 71,
    "강": 72,
    "왜": 73,
    "흉노": 74,
    "저": 75,
    "호로": 76,
    "오장원": 77,
    "적벽": 78
}