{
    "서량": 1,
    "무도": 2,
    "성도": 3,
    "건녕": 4,
    "안정": 5,
    "한중": 6,
    "검각": 7,
    "자동": 8,
    "강주": 9,
    "장안": 10,
    "영안": 11,
    "홍농": 12,
    "완": 13,
    "양양": 14,
    "강릉": 15,
    "무릉": 16,
    "영릉": 17,
    "낙양": 18,
    "신야": 19,
    "강하": 20,
    "장사": 21,
    "계양": 22,
    "남해": 23,
    "업": 24,
    "진유": 25,
    "허창": 26,
    "여남": 27,
    "시상": 28,
    "평원": 29,
    "복양": 30,
    "초": 31,
    "수춘": 32,
    "단양": 33,
    "여강": 34,
    "계": 35,
    "남피": 36,
    "소패": 37,
    "건업": 38,
    "북평": 39,
    "북해": 40,
    "하비": 41,
    "광릉": 42,
    "오": 43,
    "회계": 44,
    "양평": 45,
    "국내": 46,
    "한": 47,
    "사비": 48,
    "매소": 49,
    "서라벌": 50,
    "운남": 51,
    "천수": 52,
    "졸본": 53
}